sample_name	fw	rev
Sample_001	AATGATACGGCGACCACCGAGATCTACACGTTAAGACACACTCTTTCCCTACACGACTCGCCAAGCTGA	CAAGCAGAAGACGGCATACGAGATTATCAGCGGTGACTGGAGTTCAGACGTGTGCTCTTCCGAT
Sample_002	AATGATACGGCGACCACCGAGATCTACACTCTAAGTTACACTCTTTCCCTACACGACTCGCCAAGCTGA	CAAGCAGAAGACGGCATACGAGATTGCGTGTAGTGACTGGAGTTCAGACGTGTGCTCTTCCGAT
Sample_003	AATGATACGGCGACCACCGAGATCTACACTGTACATTACACTCTTTCCCTACACGACTCGCCAAGCTGA	CAAGCAGAAGACGGCATACGAGATCGTTATCCGTGACTGGAGTTCAGACGTGTGCTCTTCCGAT
Sample_004	AATGATACGGCGACCACCGAGATCTACACAATACCGCACACTCTTTCCCTACACGACTCGCCAAGCTGA	CAAGCAGAAGACGGCATACGAGATTCAGATACGTGACTGGAGTTCAGACGTGTGCTCTTCCGAT
Sample_005	AATGATACGGCGACCACCGAGATCTACACTGTCTATGACACTCTTTCCCTACACGACTCGCCAAGCTGA	CAAGCAGAAGACGGCATACGAGATTAGCCGATGTGACTGGAGTTCAGACGTGTGCTCTTCCGAT
Sample_006	AATGATACGGCGACCACCGAGATCTACACTCACTGTTACACTCTTTCCCTACACGACTCGCCAAGCTGA	CAAGCAGAAGACGGCATACGAGATATCCGAATGTGACTGGAGTTCAGACGTGTGCTCTTCCGAT
Sample_007	AATGATACGGCGACCACCGAGATCTACACTTGTATTCACACTCTTTCCCTACACGACTCGCCAAGCTGA	CAAGCAGAAGACGGCATACGAGATTGCTATGAGTGACTGGAGTTCAGACGTGTGCTCTTCCGAT
Sample_008	AATGATACGGCGACCACCGAGATCTACACAGACTAACACACTCTTTCCCTACACGACTCGCCAAGCTGA	CAAGCAGAAGACGGCATACGAGATGAACTACCGTGACTGGAGTTCAGACGTGTGCTCTTCCGAT
Sample_009	AATGATACGGCGACCACCGAGATCTACACATTGTCAAACACTCTTTCCCTACACGACTCGCCAAGCTGA	CAAGCAGAAGACGGCATACGAGATGGTATTCGGTGACTGGAGTTCAGACGTGTGCTCTTCCGAT
Sample_010	AATGATACGGCGACCACCGAGATCTACACGTTCTACAACACTCTTTCCCTACACGACTCGCCAAGCTGA	CAAGCAGAAGACGGCATACGAGATTACGAGTTGTGACTGGAGTTCAGACGTGTGCTCTTCCGAT
Sample_011	AATGATACGGCGACCACCGAGATCTACACTTCATTCGACACTCTTTCCCTACACGACTCGCCAAGCTGA	CAAGCAGAAGACGGCATACGAGATGCACATAGGTGACTGGAGTTCAGACGTGTGCTCTTCCGAT
Sample_012	AATGATACGGCGACCACCGAGATCTACACAAGCGTCAACACTCTTTCCCTACACGACTCGCCAAGCTGA	CAAGCAGAAGACGGCATACGAGATGAGCGATAGTGACTGGAGTTCAGACGTGTGCTCTTCCGAT
Sample_013	AATGATACGGCGACCACCGAGATCTACACCGTAGGATACACTCTTTCCCTACACGACTCGCCAAGCTGA	CAAGCAGAAGACGGCATACGAGATACGTGTTAGTGACTGGAGTTCAGACGTGTGCTCTTCCGAT
Sample_014	AATGATACGGCGACCACCGAGATCTACACAGTTAGCGACACTCTTTCCCTACACGACTCGCCAAGCTGA	CAAGCAGAAGACGGCATACGAGATTATCCAGCGTGACTGGAGTTCAGACGTGTGCTCTTCCGAT
Sample_015	AATGATACGGCGACCACCGAGATCTACACGAACGTCTACACTCTTTCCCTACACGACTCGCCAAGCTGA	CAAGCAGAAGACGGCATACGAGATTATCGGTTGTGACTGGAGTTCAGACGTGTGCTCTTCCGAT
Sample_016	AATGATACGGCGACCACCGAGATCTACACAGAACACTACACTCTTTCCCTACACGACTCGCCAAGCTGA	CAAGCAGAAGACGGCATACGAGATCTTGCGTAGTGACTGGAGTTCAGACGTGTGCTCTTCCGAT
Sample_017	AATGATACGGCGACCACCGAGATCTACACTGTTGGCAACACTCTTTCCCTACACGACTCGCCAAGCTGA	CAAGCAGAAGACGGCATACGAGATCTATTGTCGTGACTGGAGTTCAGACGTGTGCTCTTCCGAT
Sample_018	AATGATACGGCGACCACCGAGATCTACACGGCTAATAACACTCTTTCCCTACACGACTCGCCAAGCTGA	CAAGCAGAAGACGGCATACGAGATTGCGATCTGTGACTGGAGTTCAGACGTGTGCTCTTCCGAT
Sample_019	AATGATACGGCGACCACCGAGATCTACACGCTAGAATACACTCTTTCCCTACACGACTCGCCAAGCTGA	CAAGCAGAAGACGGCATACGAGATTGACGAAGGTGACTGGAGTTCAGACGTGTGCTCTTCCGAT
Sample_020	AATGATACGGCGACCACCGAGATCTACACTGTACTAAACACTCTTTCCCTACACGACTCGCCAAGCTGA	CAAGCAGAAGACGGCATACGAGATATTGGACGGTGACTGGAGTTCAGACGTGTGCTCTTCCGAT
Sample_021	AATGATACGGCGACCACCGAGATCTACACAGTTACACACACTCTTTCCCTACACGACTCGCCAAGCTGA	CAAGCAGAAGACGGCATACGAGATACATTGCCGTGACTGGAGTTCAGACGTGTGCTCTTCCGAT
Sample_022	AATGATACGGCGACCACCGAGATCTACACGTACACGAACACTCTTTCCCTACACGACTCGCCAAGCTGA	CAAGCAGAAGACGGCATACGAGATTCACTTGCGTGACTGGAGTTCAGACGTGTGCTCTTCCGAT
Sample_023	AATGATACGGCGACCACCGAGATCTACACACTGTAAGACACTCTTTCCCTACACGACTCGCCAAGCTGA	CAAGCAGAAGACGGCATACGAGATTTACCGACGTGACTGGAGTTCAGACGTGTGCTCTTCCGAT
Sample_024	AATGATACGGCGACCACCGAGATCTACACGATCATGAACACTCTTTCCCTACACGACTCGCCAAGCTGA	CAAGCAGAAGACGGCATACGAGATCATGTACCGTGACTGGAGTTCAGACGTGTGCTCTTCCGAT
Sample_033	AATGATACGGCGACCACCGAGATCTACACTGCTAACGACACTCTTTCCCTACACGACTCGCCAAGCTGA	CAAGCAGAAGACGGCATACGAGATGCTGATTCGTGACTGGAGTTCAGACGTGTGCTCTTCCGAT
Sample_034	AATGATACGGCGACCACCGAGATCTACACTAATGCTCACACTCTTTCCCTACACGACTCGCCAAGCTGA	CAAGCAGAAGACGGCATACGAGATATAAGGCCGTGACTGGAGTTCAGACGTGTGCTCTTCCGAT
Sample_035	AATGATACGGCGACCACCGAGATCTACACCTTGTTGAACACTCTTTCCCTACACGACTCGCCAAGCTGA	CAAGCAGAAGACGGCATACGAGATAAGACTAGGTGACTGGAGTTCAGACGTGTGCTCTTCCGAT
Sample_036	AATGATACGGCGACCACCGAGATCTACACGATACAAGACACTCTTTCCCTACACGACTCGCCAAGCTGA	CAAGCAGAAGACGGCATACGAGATTAGCAACAGTGACTGGAGTTCAGACGTGTGCTCTTCCGAT
Sample_025	AATGATACGGCGACCACCGAGATCTACACATACAGCGACACTCTTTCCCTACACGACTCGCCAAGCTGA	CAAGCAGAAGACGGCATACGAGATTGCTAACGGTGACTGGAGTTCAGACGTGTGCTCTTCCGAT
Sample_026	AATGATACGGCGACCACCGAGATCTACACCTGGATAGACACTCTTTCCCTACACGACTCGCCAAGCTGA	CAAGCAGAAGACGGCATACGAGATTAATGCTCGTGACTGGAGTTCAGACGTGTGCTCTTCCGAT
Sample_027	AATGATACGGCGACCACCGAGATCTACACTCATCAGCACACTCTTTCCCTACACGACTCGCCAAGCTGA	CAAGCAGAAGACGGCATACGAGATCTTGTTGAGTGACTGGAGTTCAGACGTGTGCTCTTCCGAT
Sample_028	AATGATACGGCGACCACCGAGATCTACACTTATACCGACACTCTTTCCCTACACGACTCGCCAAGCTGA	CAAGCAGAAGACGGCATACGAGATGATACAAGGTGACTGGAGTTCAGACGTGTGCTCTTCCGAT
Sample_029	AATGATACGGCGACCACCGAGATCTACACGCTGATTCACACTCTTTCCCTACACGACTCGCCAAGCTGA	CAAGCAGAAGACGGCATACGAGATATACAGCGGTGACTGGAGTTCAGACGTGTGCTCTTCCGAT
Sample_030	AATGATACGGCGACCACCGAGATCTACACATAAGGCCACACTCTTTCCCTACACGACTCGCCAAGCTGA	CAAGCAGAAGACGGCATACGAGATCTGGATAGGTGACTGGAGTTCAGACGTGTGCTCTTCCGAT
Sample_031	AATGATACGGCGACCACCGAGATCTACACAAGACTAGACACTCTTTCCCTACACGACTCGCCAAGCTGA	CAAGCAGAAGACGGCATACGAGATTCATCAGCGTGACTGGAGTTCAGACGTGTGCTCTTCCGAT
Sample_032	AATGATACGGCGACCACCGAGATCTACACTAGCAACAACACTCTTTCCCTACACGACTCGCCAAGCTGA	CAAGCAGAAGACGGCATACGAGATTTATACCGGTGACTGGAGTTCAGACGTGTGCTCTTCCGAT
Sample_045	AATGATACGGCGACCACCGAGATCTACACCAAGTAATACACTCTTTCCCTACACGACTCGCCAAGCTGA	CAAGCAGAAGACGGCATACGAGATCTTCGCATGTGACTGGAGTTCAGACGTGTGCTCTTCCGAT
Sample_046	AATGATACGGCGACCACCGAGATCTACACTCATGATGACACTCTTTCCCTACACGACTCGCCAAGCTGA	CAAGCAGAAGACGGCATACGAGATCTAGCGATGTGACTGGAGTTCAGACGTGTGCTCTTCCGAT
Sample_047	AATGATACGGCGACCACCGAGATCTACACTAGCTCTTACACTCTTTCCCTACACGACTCGCCAAGCTGA	CAAGCAGAAGACGGCATACGAGATTACGTTAAGTGACTGGAGTTCAGACGTGTGCTCTTCCGAT
Sample_048	AATGATACGGCGACCACCGAGATCTACACACTACATGACACTCTTTCCCTACACGACTCGCCAAGCTGA	CAAGCAGAAGACGGCATACGAGATAAGTAGTCGTGACTGGAGTTCAGACGTGTGCTCTTCCGAT
Sample_037	AATGATACGGCGACCACCGAGATCTACACTGTGCCATACACTCTTTCCCTACACGACTCGCCAAGCTGA	CAAGCAGAAGACGGCATACGAGATCAAGTAATGTGACTGGAGTTCAGACGTGTGCTCTTCCGAT
Sample_038	AATGATACGGCGACCACCGAGATCTACACGACTTCCAACACTCTTTCCCTACACGACTCGCCAAGCTGA	CAAGCAGAAGACGGCATACGAGATTCATGATGGTGACTGGAGTTCAGACGTGTGCTCTTCCGAT
Sample_039	AATGATACGGCGACCACCGAGATCTACACTATTCTCGACACTCTTTCCCTACACGACTCGCCAAGCTGA	CAAGCAGAAGACGGCATACGAGATTAGCTCTTGTGACTGGAGTTCAGACGTGTGCTCTTCCGAT
Sample_040	AATGATACGGCGACCACCGAGATCTACACCACTAGATACACTCTTTCCCTACACGACTCGCCAAGCTGA	CAAGCAGAAGACGGCATACGAGATACTACATGGTGACTGGAGTTCAGACGTGTGCTCTTCCGAT
Sample_041	AATGATACGGCGACCACCGAGATCTACACCTTCGCATACACTCTTTCCCTACACGACTCGCCAAGCTGA	CAAGCAGAAGACGGCATACGAGATTGTGCCATGTGACTGGAGTTCAGACGTGTGCTCTTCCGAT
Sample_042	AATGATACGGCGACCACCGAGATCTACACCTAGCGATACACTCTTTCCCTACACGACTCGCCAAGCTGA	CAAGCAGAAGACGGCATACGAGATGACTTCCAGTGACTGGAGTTCAGACGTGTGCTCTTCCGAT
Sample_043	AATGATACGGCGACCACCGAGATCTACACTACGTTAAACACTCTTTCCCTACACGACTCGCCAAGCTGA	CAAGCAGAAGACGGCATACGAGATTATTCTCGGTGACTGGAGTTCAGACGTGTGCTCTTCCGAT
Sample_044	AATGATACGGCGACCACCGAGATCTACACAAGTAGTCACACTCTTTCCCTACACGACTCGCCAAGCTGA	CAAGCAGAAGACGGCATACGAGATCACTAGATGTGACTGGAGTTCAGACGTGTGCTCTTCCGAT
